00000011111111111111111111111111111111111111111111111111111111111111
00000011111111111111111111111111111111111111111111111111111111111111
00000011111111111111111111111111111111111111111111111111111111111111
00000011111111111111111111111111111111111111111111111111111111111111
00000000111111111111111111111111111111111111111111111111111111111111
00000000011111111111111111111111111111111111111111111111111111111111
00000000001111111101111111111000011111111111111111111111111111111111
00000000000111111111111110000000011111111111111111111111111111111111
11111111000001111111111100000000011111111111111111111111111111111111
11111111100000111110100000011110011111111111111111111111111111111111
11111111110000000000000000011111011111111111111111111111111111111111
11111111111000011000000000010111111111111111111111111111111111111111
11111111111100000000000010011111111111111111111111111111111111111111
11111111111110000000101000011111111111111111111111111111111111111111
11111111111111111000101000011111111111111111111111111111111111111111
11111111111110111000000000011111111111111111111111111111111111111111
11111111111111111000100000011111111111111111111111111111111111111111
11111111111111111000000000011111111111111111111111111111111111111111
11111111111111111111111111111111111111111111111111111111111111111111
11111111111111111111111111111111111111111111111111111111111111111111
01111111111111111111111111111111111111111111111111111111111111111111
11111111111111111111110111111111111111111111111111111111111111111111
11111111111111111111111111111111111111111111111111111111111111111111
11111111111111111111111111111111111111111111111111111111111111111111
11111111111111111111111111111111111111111111111111111111111111111111
11111111111111111111111111111111111111111111111111111111111111111111
11111111111111111111111111111111111111111111111111111111111111111111
11111111111111111111111111111111111111111111111111111111111111111111
11111111111111111111111111111111111111111111111111111111111111111111
11111111111111111111111111111111111111111111111111111111111111111111
11111111111111111111111111111111111111111111111111111111111111111111
11111111111111111111111111111111111111111111111111111111111111111111
11111111111111111111111111111111111111111111111111111111111111111111
11111111111111111111111111111111111111111111111111111111111111111111
11111111111111111111111111111111111111111111111111111111111111111111
